999999999999999999999
911111111191111111119
919991999191999199919
929991999191999199929
919991999191999199919
911111111111111111119
919991919999919199919
919991919999919199919
911111911191119111119
999991999090999199999
999991900000009199999
999991909989909199999
999991909000909199999
300001009000900100003
999991909999909199999
999991900000009199999
999991909999909199999
999991909999909199999
911111111191111111119
919991999090999199919
921191111111111191129
999091919999919190999
999091919999919190999
911111911191119111119
919999999191999999919
911111111111111111119
999999999999999999999